###.########.###
###.#####......#
#.....###......#
#.....###......#
#...............
......###......#
#.....###......#
##.######......#
##.########.####
##.########.####
##......##....##
........##......
##............##
##......##....##
##......####.###
###.########.###
