##..##......
.....#.#####
............
#####.##.###
#####.#.....
###...#..###
###.####..##
###.####..##
..........#.
......##....
##..###..###
########....